-----------
--||||-----
--|  ||----
-||#  ||||-
-|> |    |-
-||#   # |-
-| o ||#||-
-|ooo | |--
-||||   |--
----|||||--
-----------