----------
----|||||-
---||  ||-
---|  # |-
-||| ##>|-
-|    # |-
-| || |||-
-|oooooo|-
-| # || |-
-|  ##o |-
-|    |||-
-||||||---
----------