------------
-||||-------
-|  |||||---
-|  #   |||-
-|  #   # |-
-||#|||#| |-
-|   |oo| |-
-| > #oo| |-
-||  |oo  |-
--|||||||||-
------------