---------
-|||||||-
-|o>| o|-
-| #|# |-
-|     |-
-| #|  |-
-|  |  |-
-|||| o|-
----||||-
---------