-------------
-|||||||||||-
-|>        |-
-| |###| | |-
-| # |ooo o|-
-| #o|x o ||-
-| |o o|| ||-
-|  #| |  ||-
-||   # # ||-
-||||||   ||-
-|||||||||||-
-------------