----------
-||||||||-
-| o   o|-
-| #    |-
-|o#|  #|-
-|o   #>|-
-||||||||-
----------