------------
--|||||-----
--|o o|||||-
-||x##|   |-
-| o>#    |-
-| x##|||||-
-| oo |-----
-||||||-----
------------