---------
-|||||||-
-|||o ||-
-| # #>|-
-|ooxo |-
-| # #||-
-|    ||-
-|||||||-
---------