-------------
------|||----
------|>|----
---|||| |----
---|    ||||-
-||| |   #o|-
-|o| |   |||-
-| |#  | |o|-
-|     | # |-
-|  ||     |-
--|| |||||||-
-------------