-------------
-|||||||||||-
-|  o|>|  o|-
-| | | | | |-
-| | | | | |-
-|   # #   |-
-|   # #   |-
-|   |||   |-
-| | ||| | |-
-|o  |||o  |-
-|||||||||||-
-------------