----------------------------------------
-||||||||||||||||||||||||||||||||||||||-
-|                                    |-
-| >               #                 o|-
-|                                    |-
-||||||||||||||||||||||||||||||||||||||-
----------------------------------------